010B010B010B010B010B010B010B010B010B010B010B010B010B010B010B010B010B010B010B010B010B010B010B010B010B010B010B010B010B010B010B000300030003000300030003000300030003010B010B010B010B010B010B010B0003000300030003000300030000000300000000000000000000010B010B010B010B010B000300030003000300030003000000000000000000000000000000000000010B010B010B00030003000300030003000000000000000000000000000000000000000000000000010B010B010B00030003000000030000100000000000000000000000000000000000000000000000010B010B000300030003000300000000000000000000000300030000000000000000000000000000010B010B000300030003000000000000000000000003000300000000000000000000000000000000010B010B000300030000000000000000000000000000000000000000000000000000000000030000010B0003000300030000000000000000000000000000000000000000000000000003000300030000010B0003000300000000000000000000000000000000000000000000000000000000000000000000010B0003000300000000000000030003000000000000000000000000000000000000000000000000010B0003000000000000000300000000000000000000000000000000000000000000000000000000010B0003000000000000000000000000000000000000000000000000000000000000000000000000010B0003000000000000000000000000000000000000000000000000000000000000000000000000
010B010B010B010B010B010B010B010B010B010B010B010B010B010B010B010B010B010B010B010B00030003000300030003010B010B010B010B010B0D0B010B010B010B010B010B010B010B010B010B0000000000030003000300030003010B010B010B010B010B010B0100010B00030003000000000000000000000000000300030003000300030003000300030003000300000000000300000000000300000000000000000000000300030003000300030003000000000000000300000000000000000000000000000000000000000000000000000E030003000000000000000000000000000000000000000000000000000000000000000000000000000000000000000000000000000000000000000000000000000000000000000000000000000000000000000000000000000000000108010800000000010800000000000000000000000000000900000000000000000001080000100000000108010801080108000000000000000000000000000000000000000000000108010801080000000000000000000C000000000000000000000000000000000000000001080108000001080000000C000C000C0000090C000000000000000000000000000000000108000000000000000C000C000C00000000000C0000000000000000000000000000000C00000000000C000C000C000C000C000C000000000000000000000E00000000000000000000000000000000000000000C000C000C0000000000000000000000000000000000000000000000000000000000000000000000000000000000000000000000000000000000000000000000000000
010B010B010B010B010B010B010B010B010B010B010B010B010B010B010B010B010B010B010B010B010B010B010B010B010B010B010B010B01090109010B010B010B010B010B010B010B010B010B010B0000000000000000000000000000010901090000010B0001000100010000000100010001000100010000000000000000000000000000000000000000010B010B000100010001000100010001000100010000000000000E0000000000000010000000000000000109000000000000000000010001000100010000000000000000000000000000000000000000000C010B010B0000000000000001000100010001000000000000000000000000000C000C000C000C000C010B0109000000000001000100010001000100000000000000000000000C000C000C0000000000000300060103010000000000010001000100010000000001080000000C000C000C000C0000000C000C00000109010B00000000000100010001000100000000000001080000000C000C000C000C000000000000010B010B0001000100010001000100010000000000000000000000000000000000000000000000000000010B0000000000000001000100010000000000000000010800000000010800000E00000000000000010B010B010B010B010B010B010B00000000000000000108000000000000000000000000010B010B010B010B010B01090001010B010B000000000000000000000000000000000000010B010B010B010B010B010B000100010109010B010B000000000000000000000000000000000000010B010B010B010B010B010B010B010B010B010B010B
010B010B010B010B010B010B010B010B010B010B010B010B010B010B010B010B010B010B010B010B010B010B010B010B010B010B010B010B010B010B010B010B010B010B010B010B010B010B010B010B000100010001000100010001010B010B010B010B010B010B010B010B010B010B010B010B010B010B0001000100011001000101090001000100010001000100010001010B0001000100010B01010B010B00010001000100010001010900010001000100010001000100010001010B0001000100010001010B0001000100010001000101090001000100010001000100010001000100010801080100010001010B00010001000100010201050100010001000100010001000100010001000100010001010B010B010B0001000100010001020105010001000100010001000100010001000100010001000100010001010B0001000100010001000101090001000100010001000100010001000100010001000100010001010B0001000100010001000101090001000100010001000100010001000100010001000100010001010B0001000100010001000101090001000100010001000100010001000100010001000100010001010B010B010B010B010B010B010B000100010001000100010001000100010001000100010001010B010B010B010B010B010B010B010B010B010B010B010B010B010B010B010B010B010B010B010B010B010B010B010B010B010B010B010B010B010B010B010B010B010B010B010B010B010B010B010B010B010B010B010B010B010B010B010B010B010B010B010B010B010B010B010B010B010B010B010B010B010B






010B0003000000000000000000000000000000000000000000000000000000000000000000000000010B0003000000000000000000000000000000000000000000000000000000000000000000000000010B0003000300000000000000000000000000000000000000000000000000000000000000000000010B00030A0300000000000000000000000300000000000000000000000000000000000000000000010B0003000300030003000000000000000300030000000000000000000000000000000000000000010B0003000300030003000000000000000000000000000000030000000000000000000000000000010B000300030A030003000000000000000000000000000000000003000300000000000000000000010B0003000300030003000300000000000000000000000000000000000300000000000000000000010B0003000300030003000010000000000000000000000000000000000000000000000000000000010B0003000300030003000300000000000300030003000000000000000000000003000000000000010B010B00030003000300030003000300030A030003000300030000000000000000000000000000010B010B010B00030003000300030003000300030A030000000300030C03000300000000000000000104010B010B000B000300030003010B000300030003000300030000000300030A03000000000000010401040D0B010B010B010B010B010B00030003000300030003000300030003000300030003000301040104010B010B010B010B010B010B010B010B010B010B010B010B010B010B010B010B010B010B
00000000000000000000000000000000000000000000000000000000000000000000000000000000000000000000000000000000000000000000000000000000000000000000000000000000000000030000000000000000000000000000000000030003000000000000000000000000000000000003000300000000000000000000000000000000000300000000000000080000000000030000000300030003000000000000000000000000000000000000000000080008000800000000000000000003000300030000000000030003000000000008000000080008000010000000000000000003000300030003010B000000000000000000000008000000000000000000000000000000000003000300030003010B010B00000000000000000000000000000000000000000000000000030003000300030003010B010B010B0000000000000003000300030000000000000000000300030003000300030003010B010B010B010B000000000000000300000000000000000003000300030003000300030003010B010B010B010B010400000000000000000000000000000003000300030003000300030003010B010B010B010B010401040000000000000000000000030003000300030003000300030003010B010B010B010B010B010B010B000000030003000300030003000300030003000300030003010B010B010B010B01040104010B010B0003000300030003000300030003000300030003010B010B010B010B010B01040104010C010B010B010B010B010B010B010B010B010B010B010B010B010B0104010B010B010B000401040104010B010B
000000000000000000000000000000030003010B010B010B010B010B010B010B010B010B010B010B0000000000000000000000030003010B010B010B010B010B010B010B010B010B010B010B010B010B00030000000010000003010B010B010B010B010B010B010B010B00040004010B010B010B010B010B000300030003000B010B010B010B010B010B010B010B010B0004000C00040004010B010B010B010B00030003010B000B010B010B010B010B010B010B010B010B010B00040004000C0004010B010B010B010B010B010B000B010B010B010B010B010B010B010B010B010B010B00040004000B010B010B010B010B010B010B000B010B010B0004000400040004010B010B010B010B010B010B000B010B010B010B010B010B010B000B010B010B000B0004000400040004010B010B010B010B010B000B010B010B010B010B010B010B000B010B010B000B00040004000B000B000B000B010B010B010B000B010B010B010B010B010B0004000B010B010B000B010B010B010B010B0001010B0001000100010001010B010B010B010B010B000400040004000B000B010B010B010B010B0001000100010001000900010001010B010B010B010B010B00040004010B010B010B010B010B010B0001000900010001000100010001010B010B010B010B010B010B010B010B010B010B010B010B010B000100010001000100010001010B010B010B010B010B010B010B010B010B010B010B010B010B010B010B010B010B010B010B010B010B010B010B010B010B010B010B010B010B010B010B010B010B010B010B010B010B010B010B010B010B010B010B