01080108010801080108010801080108010801080108010801080108010801080108010801080108010801080108010801080108010801080108010801080108010801080108010801080108010801080108010801080A00010801080108010801080108010801080108010800000000010801080000000001080108000000000000000000000000010801080108010801080000000000000000000000000000010800000000000000000000000000000000010801080108000000000000000000000000000000000108000000000000000000000000000000000000000000000000000000000000000000000000000001080000000000000000000000000000000000000000000000000000000000000000000000000000010800000000000000000000000000000A0001080108000000000000000000000000000000000000010800000000000000000000000000000108010801080000000000000000000000000000000000000108000000000000000000000000000001080108000000000000000000000000000000000000000001080108000000000000000000000000000000000000000000000A000000000000000000000000000108010801080000000000000000000000000000010801080108010801080A000000000000000000010801080108010801080000000001080108010801080108010801080108010801080000000000000108010801080108010801080108010801080108010801080108010801080108010801080108010801080108010801080108010801080108010801080108010801080108010801080108010801080108
0108010801080108010801080108010801080108010801080108010801080108010801080108010801080108010801080108010801080108010801080108010801080108010801080108010801080108000000000000000000000000000001080108010801080108010801080108010801080108010801080000000000000000000000000000000000000000010801080108010801080108010801080108010800000000000000000000000001080108010800000000000001080108010801080108010801080108000000000000000000000108010801080108010801080000000001080108010801080108010801080000000000000000010801080000000000000C0001080108000000000000000001080108010801080000000000000000010801080000000000000000000001080108000000000000000001080108010800000000000000000000000000000000000000000000000001080108000000000000010801080108000000000000000000000000000000000000000000000108010801080108000000000108010801080000000000000000000000000000000000000000000000000108010801080000000000000108010800000000000000000000000000000000000000000000000000000000000000000000000001080108000000000000010801080108010801080108010801080000000000000000000000000000010801080108010801080108010801080108010801080108010801080000000000000000000000000108010801080108010801080108010801080108010801080108010800000000000000000000000001080108
010B010B010B010B010B010B010B010B010B010B010B010B010B010B010B010B010B010B010B010B010B010B010B010B010B0D0B010B010B010900010001000101090109000100010001000101090109010B0D0B010901090109010B01090109000100010001000100010001000100010001000100010001010B010B01090001000100010001000100010A010001000100010001000100010001000100010001010B010900010001000100010001000100010001000100010A010001000100010001000100010001010B0109000100010001000100010001000100010001000100010001000100010001000100010001010B0001000100010001000100010001000100010001000100010001000100010001000100010001010B000100010B010001000100010001000100010001000100010001000100010E01000100010001010B0001000100010001000100010001000100010001000100010109000100010001000100010001010B0109000100010001000100010001000100010001000100010001000100010001000100010001010B010900010001000100010001000100010A010001000100010001000100010001000100010001010B010B000100010001000100010001000100010001000100010001000100010001000100010001010B010B000100010001000100010001000100010001000100010001000100010001000100010001010B0109000100010001000100010001000100010001000100010001000100010001000100010001010B0109000100010001000100010001000100010001000100010001000100010001000100010001
010B010B010B010B010B010B010B010B010B010B010B010B010B010B010B010B010B010B010B010B010901090109010B010B000901090109010B010B010B010B010B010B010B010B010B010B010B010B000100010001000100010001000100010001010B0001000100010001010B010B010B010B010B010B000100010001000100010001000100010001010B00010001000100010001000100010001010B010B00010001000100010001000100010B010001010B010B000100010001000100010001000100010001000100010001000100010001000100010001010B010B0001000100010001000100010001000100010001000100010001000100010001000100010001010B010B0001000100010001000100010001000100010001000100010001000100010001000100010001010B010B010B000100010E0100010001000100010001000100010001000100010001000100010001010B010B010B00010001000100010001000100010001000100010001000100010001000109010001010B010B010B00010001000100010001000100010001000100010001000100010001000100010001010B010B000100010001000100010001000100010001000100010001000100010001000100010001010B000109010001000100010001000100010001000100010001000100010001000100010001010B010B00010001000100010001000100010001000100010001000100010001000100010B010001010B010B010B00010001000100010001000100010001000100010001000100010001000100010001010B000100010001000100010001000100010001
010B010B010B010B010B010B010B010B010B010B010B010B010B010B010B010B010B010B010B010B010B010B010B010B010B010B010B0D0B010B010B010B010B010B010B010B010B010B010B010B010B010B010B0D0B010B010B010B010B010B010B010B010B010B010B010B010B010B010B0D0B010B010B010B010B010B010B010B010B010B010B010B010B010B010B010B010B010B010B010B010B010B010B000100010001000100010001010B010B010B010B00010001000100010001010B010B010B010B010B00010001000100010001000100010001010B0001000100010001000100010001010900010001000100010001000100010A0100010001010B010B00010A01000100010A0100010001000100010001000100010001000101090001000100010001010B00010001000100010001000100010001000100010001000100010001000100010001000100010001000100010001010900010001000100010001000100010001000100010001000100010001010900010A0100010001000100010001000100010001000100010001000100010001000100010001000100010001000100010001000100010109000100010001000100010001000100010001010900010001000100010001000100010001000100010001000100010001000100010001000100010001000100010001000100010001000100010001000100010A01010B010B0001000100010001000100010001000100010001000100010001000100010109010B010B0D0B010B000100010001000100010001000100010001000100010001000100010109010B010B010B010B010B
010B010B010B010B010B010B010B010B010B010B010B010B010B010B010B010B010B010B010B010B010B010B010B010B010B010B010B010B010B010B010B010B010B010B0001010B010B010B010B010B010B010B010B010B0001010B000100010001010B000100010001010B010B010B010B010B0109010B010B010B0001010B010B010B00010A01000100010001000100010001010B010B0109010B010B010B000100010001010B010B0001000100010A0100010109010901090001010B010B010B010B010B010B000100010001010B0001000100010001000100010001000101090001010B010B00010001010B010B00010001000101090001000100010001000100010001000101090001010B0001000100010001010B000100010301060100010001000100010001000100010001010900010801000100010B010001010B0001000100010109000100010001000100010001000100010109000108010001000100010001010B000100010001010B0109000100010001000100010001000101090001010B0001000100010001010B000100010001010B010B000100010001000100010109010901090001010B010B000100010001010B00010001010B010B0001000100010A01000100010001000100010001010B010B010B010B010B010B010B010B010B010B00010A0100010001000100010001000100010001010B010B010B0001010B010B010B010B010B00010001000100010001010B010B0001010B010B010B010B0109010B010B010B010B010B010B010B010B010B010B010B010B010B010B010B010B010B010B010B010B010B010B010B010B


010A010A010A010A010A010A010A010A010A010A010A010A010A010A010A010A010A010A010A010A010A010A0A020A020A020A020A020A020A020A020A020A020A020A020A020A020A020A02010A010A010A0A020B020002000200020002000200020A02000200020002000200020002000200020A02010A010A0A020002000200020002000200020002000200020002000200020E020002000200020A02010A010A0A020002000200020E020002000200020002000200020A02000200020002000200020A02010A010A0A0200020002000200020002000200020A020A020A0200020A020A020A02000200020A02010A010A00020A020A020A020A020A020A020A020002000200020A02000200020002000200020A02010A010A0A0200020002000200020002000200020002100200020A02000200020002000200020A02010A010A0A0200020002000200020002000200020002000200020A02000200020A020A020A020002010A010A0A0200020002000200020002000200020A020A020A020002000200020A02000200020002010A010A0A0200020002000200020A020A020A020002000200020002000200020A0200020F020002010A010A0A0200020002000200020002000200020002000200020E02000200020A0200020D020002010A010A0A0200020002000200020002000200020002000200020002000200020A0200020F02010A010A010A010A0A020A020A020A020A020A020A020A020A020A020A020A020A02010A010A010A010A010A010A010A010A010A010A010A010A010A010A010A010A010A010A010A010A010A010A010A010A010A
010A010A010A010A010A010A010A010A010A010A010A010A010A010A010A010A010A010A010A010A010A010A010A010A010A010A010A0002000200020F020F020F02000200020002010A010A0D0A010A010A010A010A00020002000200020002000200020002000200020002000200020F02010A010A010A010A0D0A010A0F0200020A0200020002000200020B0200020A020A020002000200020002010A010A010A010A010A0002000200020002000200020002000200020002000200020002000200020002010A010A010A00020002000200020002000200020002000200020002000200020002000200020F02010A010A000200020002000200020002000200020002000200020002000200020002000200020F02010A010A0F020002000200020002000200020002000210020002000200020002000200020A020F02010A010A0F020002000200020002000200020002000200020002000200020002000200020A020002010A010A0F020A020002000200020002000200020002000200020002000200020002000200020002010A010A000200020002000200020002000200020002000200020002000200020002000200020002010A010A00020002000200020002000200020002000200020002000200020002000200020002010A010A010A010A000200020002000200020A0200020002000200020002000200020A0200020E02010A010A010A0D0A010A000200020F0200020002000200020F020F0200020F020002000200020002010A010A010A010A010A010A010A010A010A010A010A010A010A010A010A010A010A010A010A010A010A010A
010F010F010F010F010F010F010F010F010F010F010F010F010F010F010F010F010F010F010F010F010F010F010F010F010F010F010F010F010F010F010F010F010F010F010F010F010F010F010F010F010F010F010F010F010F010F010F0007000700070007010F0007010F010F010F010F010F010F010F010F010F010F0007010F010F010F0007000700070007010F000700070007000700070007010F010F010F010F00070007000700070007000700070007000700070007000700070007000700070007010F010F000700071007000700070007000700070B070007000700070007000700070A0700070007010F010F00070007000700070007000700070007000700070007010B010B010B0007000700070007010F010F010F0007000700070007000700070007000700070007010B010B010B010B000700070007010F010F000700070007000700070007000700070007000700070007010B010B0007000700070007010F010F000700070A0700070007000700070007000700070A070007000700070007000700070007010F010F010F00070007000700070007000700070007000700070007000700070007000700070007010F010F010F00070007000700070007000700070007000700070007000700070007000700070007010F010F0007000700070007000700070007000700070007000700070007000700070A0700070007010F010F000700070007000700070007000700070007000700070007000700070007000700070007010F010F000700070007000700070007000700070007000700070007000700070007000700070007010F
01080108010801080108010801080108010801080108010800000000000000000000000001080108010801080108010801080108010801080108010801080108000000000000000000000000010801080108010801080108010801080108010801080108000000000000000000000000000000000108010801080108010801080000000000000000000000000000000700000000000000000000000001080108010801080108000000000A000000000000000000000000000000000000000000000000000108010801080108000000000000000000000000000000070000000000000000000000000000000001080108010801080000000000070000000000000007000F0007000000000000000F0000000000000108010801080108000000000007000000000007000F0B0F000F000700000000000000000000000001080108010801080000000000000000000000000007000F00070000000000000A0000070000000001080108010801080000000000000000000000000000000700000000000000070007000700000000010801080108010800000A0000000000000700000000000000000A0F000000000000000000000A000108010801080108010800000000000000070000000000000000000000000000000F00000000010801080108010801080108010800000000000000000A000A0000000000000000000000000000000108010801080108010801080108010801080108010801080108010801080108010801080108010801080108010801080108010801080108010801080108010801080108010801080108010801080108010801080108
010B0109000100010001000100010001000100010001000100010001000100010001000100010001010B0109000100010001000100010001000100010001000100010001000100010001000100010001010B010B010900010001000100010001000100010001000100010001000100010001000100010001010B010B0109000100010001000100010001010B00010001000100010001000100010001000100010D0B010B0109000100010001000100010001010B010B00010001000100010A010001000100010001010B010B00010001000100010001000100010001010B010B0E010001000100010001000100010001010B010B0001000100010001000100010A0100010001010B010B010B0001000100010A0100010001010B010B00010001000100010A010001000100010001010B010B010B010B00010001000100010001010B0001000100010001000100010001000100010001000100010001010B00010001000100010001010B0001000100010001000100010001000100010001000100010001000100010001000100010001010B0001000110010001000100010001000100010001000100010001000100010001000100010001010B0001000100010001000100010001000100010001000100010001000100010001000100010001010B010B00010001000100010109010900010001010B010B0001000101090001010B010B00010001010B010B0001000101090109010B010B010B010B010B0D0B010B010B010B010B010B010B010B010B010B010B010B010B010B010B010B010B010B010B010B010B010B010B010B010B010B010B010B010B
0001000100010001000100010001000100010001010B000100010001000100010001000100010001000100010001000100010001000100010001010B010B000100010109000100010001000100010001000100010001000101090001010900010001010B0001000100010001000100010001000100010001000100010001000100010001000100010001010B000100010001000100010001000100010001000100010001010900010001000100010001010B010B000100010001000100010001000100010001000100010001000100010001000100010001010B010B000100010001000100010001010900010001000100010001000100010001000100010001010B0001000100010001000100010001000100010001000100010001000100010001000109010001010B010B000100010901000100010001000100010001000100010001000100010001000100010001010B0D0B010B00010001000100010001000101090001000100010001000101090001000100010001010B010B010B000100010001000100010001000100010001000100010001000100010001000100010001010B0001000100010001000100010001000100010001000100010001000100010001000100010001010B0001010B010B000100010001000100010001000100010001010901090109010B010B00010001010B010B010B0001000100010001000100010001010B010B010B010B010B010B0D0B010B010B01090001010B010B010B0001010901090001010B010B010B010B010B010B010B010B010B010B010B010B010B010B010B010B010B010B010B010B010B0D0B010B
000100010001000100010001000100010001000100010001000100010109010B010B010B010B010B000100010001000100010001000100010001000100010A01000100010109010B010B010B010B010B00010001000100010001000100010001000100010001000100010001010B010B010B010B010B010B000100010001000100010001000100010A0100010001000100010109010B010B010B010B010B010B0001000100010001000100010001000100010001000100010001010B010B010B010B010B010B010B000100010001000100010001000100010001010901090001010B010B010B010B010B010B010B010B0001000100010001000100010001000100010109010B010B010B010B010B00010F01010B010B010B000100010001000100010001000100010109010B010B010B010B010B0F01000100010001010B010B00010001000100010A0100010109010B010B010B010B010B010B010B0001000101090001010B010B0001000100010001000100010109010B010B010B010B010B010B000100010F0101090001010B010B0001000100010109010B010B010B010B010B010B010B010B010B0001010900010D0100010001010B000100010109010B010B010B010B010B010B010B010B010B010B0001000100010F0100010109010B0109010B010B010B010B010B010B010B010B010B010B010B010B010B010B000100010001010B010B010B010B010B010B010B010B010B010B010B000B010B010B010B010B010B010B010B010B010B010B010B010B010B010B010B010B010B010B010B010B010B010B010B010B010B010B010B010B010B010B





010F000700070007000700070007000700070007000700070007000700070007000700070007010F010F000700070007000700070007000700070007000700070007000700070007000700070007010F010F00070007000700070007000700070007000700070007000700070007000700070007010F010F010F00070007000700070007000700070007000700070007000700070007000700070A07010F010F010F00070007000700070007000700070007000700070007000700070007000700070007010F010F010F010F000700070A0700070007000700070007000700070007000700070007000700070007010F010F010F00070007000700070007000700070007000700070007000700070E070007000700070007010F010F000700070007000700070007000700070007000700070007000700070007000700070007010F010F010F00070007000700070007000700070007000700070007000700070007000700070007010F010F010F010F000700070E070007000700070007000700070007000700070007000700070007010F010F010F010F0007000700070007000700070007000700070007000700070007000700070007010F010F000700070007000700070007000700070007000700070007000700070007000700070007010F010F00070A070007000700070007000700070007000700070007000700070007000700070007010F0007000700070007000700070007000700070007000700070007000700070007000700070007010F0007000700070007000700070007000700070007000700070007000700070007000700070007
010F010F010F010F010F010F010F010F010F010F010F010F010F010F010F010F010B010B010F010F010F0D0F010F010F010F010F0007000700070007000700070007000700070007010B010B00070007010F010F010F0007000700070007000700070007000700070A07000700070007010B010B00070007010F010F00070007000700070007000700070007000700070007000700070007010B010B00070007010F010F00070007000700070A07000700070007000700070007000700070007010B010B00070007010F000700070007000700070007000700070007000700070007000700070007010B000700070007000700070007000700070007000700070007000700070007000700070007020705070007000700070007000700070007000700070007000700070007000700070007000700070007010B0007000700070007000700070007000700070007000700070007000700070007000700070007010B010B000700070007000700070007000700070007000700070007000700070007000700070007010B010B000700070007000700070007000700070007000700070007000700070007000700070007010B010B0007000700070007000700070E0700070007000700070007000700070007000700070007010B010B0007000700070007000700070007000700070007000700070A07000700070007000700070007010B010B010B000700070007000700070007000700070007000700070007000700070007000700070007010B010B000700070007000700070007000700070007000700070007000700070007000700070007010B010B
010F010F010F010F010F010F010F010F010F010F010F010F010F010F010F010F010F010F010F010F00070007000700070007000700070007010F00070007010F010F010F010F010F010F0007010F010F00070007000700070007000700070007010F0007000700070007010F010F0007000700070007010F0007000700070007000700070007020705070007000700070007080700070007000700070007010F00070007000700070007000700070007010F0007000700070007010F00070007000700070007010F00070007000700070007000700070007010F0007000700070007010F010F010F000700070007010F00070007000700070007000700070007010F0007000700070007010F010F010F000700070007010F00070007000700070007000700070007010F0507050706070607010F010F010F00070B070007010F00070007000700070007000700070007010F0007000700070007010F010F010F000700070007010F00070007000700070007000700070007010F0007000700070007010F010F010F000700070007010F00070007000700070007000700070007010F0007000700070007010F00070007000700070007010F0007000700070007000700070007030706070007000700070007080700070007000700070007010F010F0007000700070007000700070007010F0007000700070007010F010F0007000700070007010F010F010F000700070007000700070007010F0007010F010F0007010F010F010F00070007010F010F010F010F010F010F010F010F010F010F010F010F010F010F010F010F010F010F010F010F010F010F







010F0007000700070007000700070007000700070007000700070007000700070007000700070007010F0007000700070007000700070007000700070007000700070007000700070007000700070007010F0007000700070007000700070007000700070007000700070007000700070007000700070007010F00070007000700070E0700070007000700070007000700070007000700070007000700070007010F000700070007000700070007000700070007000700070007000700070E070007000700070007010F000700070007000700070007010F010F010F0007000700070007000700070007000700070007010F00070007000700070007010F010F010F010F010F000700070007000700070007000700070007010F00070007000700070007010F010F010F0D0F010F010F00070007000700070007000700070007010F000700070007000700070007010F010F010F010F010F010F0007000700070007000700070007010F010F000700070007000700070007010F010F010F010F00070007000700070007000700070007010F010F000700070007000700070007000700070007000700070007000700070007000700070007010F010F0007000700070007000700070E0700070007000700070007000700070007000700070007010F0007000700070007000700070007000700070007000700070007000700070007000700070007010F0007000700070007000700070007000700070007000700070007000700070007000700070007010F0007000700070007000700070007000700070007000700070007000700070007000700070007
000700070007000700070007000700070007000700070007000700070007000700070007010B010B000700070007000700070007000700070007000700070007000700070007000700070007010B010B00070007000700070007000700070007010F010F010F010F0007010F010F010F010F010F010B010B0007000700070007000700070007010F0007000700070907010F090700070907010F010B010B010B0007000700070007000700070007010F0907000700070007010F000700070007010F010B010B010B00070007000700070007000700070007010F010F010F010F0007010F010F010F010F010B0007000700070007000700070007000700070007000700070007000700070007000700070007010B000700070007000700070007000700070007000700070007000700070907000700070007000705070207000700070007000700070007000700070007000700070007000700070007000700070007010B000700070007000700070007000700070007000700070007000700070007000700070007010F010B000700070007000700070007000700070007000700070007000700070007010F010F010F0007010B010B010F0007000700070007000700070007010F010F010F010F010F010F010F090700070207010B010B010F000700070007000700070007010F00070007010F000700070907010F000700070007010B010B010F0007000700070007010F010F010F00070907010F00070007010F010F010F010F010F010B010B010F000700070007010F010F010F010F010F010F010F010F010F010B010B010B010B010B010B010B010B
010F010F010F010F010F010F010F000C000C000C000C000C000C000C000C000C000C000C000C000C010F010F0007000700070007010F000C000C000C000C000C000C000C000C000C000C000C000C000C010F010F0007000700070007010F010F010F010F010F010F010F010F010F010F000C000C000C000C010F00070007000700070007010F00070007000700070007000700070007010F000C000C000C000C010F00070007000700070007010F00070007000700070007000700070007010F000C010F010F000C000700070007000700070007010F00070007000700070007000700070007010F010F00070007010F0007000700070007000704070707000700070007000700070007000700070807000700070B07010F0007000700070007000704070707000700070007000700070007000700070807000700070007010F000700070007000700070007010F00070007000700070007000700070007010F010F00070007010F000700070007000700070007010F00070007000700070007000700070007010F000C010F010F000C010F00070007000700070007010F00070007000700070007000700070007010F000C000C000C000C010F00070007000700070007010F00070007000700070007000700070007010F000C000C000C000C010F010F0007000700070007010F00070007000700070007000700070007010F000C000C000C000C010F010F0007000700070007010F010F010F010F010F010F010F010F010F010F000C000C000C000C010F010F010F010F010F010F010F000C000C000C000C000C000C000C000C000C000C000C000C000C







010F0007000700070007000700070007000700070007000700070007000700070007000700070007010F0007000700070007000700070007000700070007000700070007000700070007000700070007010F0007000700070007000700070007000700070007000700070007000700070007000700070007010F0007000700070007000700070007000700070007000700070007000700070007000700070007010F010F00070E070007000700070007000700070007000700070007000700070007000700070007010F010F0007000700070007000700070007000700070007010F010F010F010F010F000700070007010F010F00070007000700070007000700070007000700070007010F010F010F010F010F00070007010F010F0007000700070A07000700070007000700070C07000700070007010F010F000700070007010F010F010F00070007000700070007000700070007000700070007000710070007000700070007010F010F010F010F0007000700070007000700070007000700070007000700070007000700070007010F010F010F010F010F00070007000700070A070007000700070007000700070007000700070007010F010F010F010F010F010F010F000700070007000700070007000700070A070007000700070007010F010F010F0D0F010F010F010F010F000700070007000700070E07000700070007000700070007010F010F010F010F010F010F010F010F010F00070007000700070007000700070007000700070007010F010F010F010F010F010F010F010F010F010F010F010F010F010F010F010F010F010F010F010F
000700070007010F010F010F010F010F010F010F010F010F010B010B010B010B010B010B010B010B0007000700070007010B010B010B010B010B010B010B010B010B010B010B010B010B010B010B0007000700070007010B010B000B010B010B010B010B010B010B010B010B010B010B0007000700070007000700070007010B010B010B000700070007000700070007000700070007000700070007000700070007000700070007010B010B000700070007000700070007000700070007000700070007000700070007000700070007010B010B00070007000700070007000700070007000700070007000700070007000700070007010B010B000700070007000700070007000700070007000700070007000700070007000700070007010B010B010B00070007000700070007000700070007000700070007000700070007000700070007010B010B010B010B010B010B010B0007000700070007000700070007000700070007000700070007000700070007010B010B010B010B010B010B010B010B000700070007000700070007000700070007000700070007000710070007000700070007010B010B010B010B010B010B000700070007000700070007000700070007000700070007000700070007010B010B010B010B010B00070007000700070007000700070007000700070007000700070B070007000700070007010B010B000700070007000700070007000700070007000700070007000700070007000700070007010B010B00070007010F010F010F010F010F010F010F010F010F010F010F010F010F010F010F010F010B010B010F010F
010C010C010C010C010C010C010C010C010C010C010C010C010C010C010C010C010C010C010C010C010C010C010C010C010C010C010C010C010C010C010C010C010C010C010C010C010C010C010C010C010C010C010C00040004000400040004000400040004010C010C010C010C010C010C010C010C010C010C010C00040004000400040A04000400040004000400040004010C010C010C010C010C010C010C010C010C00040A040004000400040004000400040A04000400040004010C00040004010C010C010C010C0004000400040004000400040004000400040004000400040A040004000400040004010C010C010C00040A040004000400040004000400040004000400040004000400040A0400040004010C010C010C00040004000400040004000400040004000400040004000400040004000400040004010C010C010C0004000400040004000400040004000400040004000400040004000400040A0400040004010C010C0004000400040A0400040004000400040004000400040004000400040004000400040004010C010C08040804010C0004000400040A0400040004000400040004000400040004000400040004010C010C00040004010C010C010C010C0004000400040A04000400040004000400040A040004010C010C010C000400040B0400040004010C010C000400040004000400040A040004000400040004010C010C010C010C0004000400040004010C010C010C010C010C010C0004000400040004010C010C010C010C010C010C010C010C010C010C010C010C010C010C010C010C010C010C010C010C010C010C010C010C
010B010B010B010B010B010B010B010B010B010B010B010B0A030A030A030A030A030A030A030108010B010B010B010B010B010B00030003000300030003000300030003000300030003000300030108010B010B010B010B0003000300030003000300030003000300030003000300030003000300000108010B010B010B00030003000300030003000300030003000300030003000300030003000000000108010B010B010B00030003000300030003000300030003000300030003000300030003000301080108010B010B000300030003000300030003000300030003000300030003000300030003000301080108010B010B000300030003000300030003000300030003000300030003000300000000000301080108010B010B000300030003000300030003000300030003000300030003000000000003000001080108010B010B000300030003000300030003000300030003000300000003000000000000010801080108010B010B000300030003000000030003000300030000000000000000000000000000010801080108010B010B0003000300030000000300030003000000000000000000000000000001080108010801080A0300030003000300030000000000000000000000000000000000000000000001080108010801080A0300030003000300030000000000000000000000000000000000000000000001080108010801080A00000000000000000001080108010801080108010801080108010801080108010801080108010801080108010801080108010801080108010801080108010801080108010801080108010801080108