010801080108010801080108010801080108010801080108010801080108010801080108010801080108090009000900090009000000000000000000000000000000000000000000000000000A00010801080900000000000000000000000000000000000000000000000000000000000000000000000108010809000000000000000000000000000000000000000000000000000000000000000000000001080108090000000000000000000000000000000000000000000000000000000000000000000000010801080900000000000000000000000000000000000000000000000000000000000000000000000108010800000000000000000000000000000000000000000000000000000000000000000000000001080108000000000000000000000000000000000000000000000000000000000000000000000200050001080000000000000000000000000000000000000000000000000000000000000000000000000108010800000000000000000000000000000000000000000000000000000000000000000000000001080108000000000000000000000000000000000000000000000000000000000000000000000000010801080000000000000000000000000000000000000000000000000000000000000000000000000108010800000000000000000000000000000000000000000000000000000000000000000000000001080108000000000000000000000000000000000300000000000000000000000000000000000000010801080108010801080108010801080108010806000108010801080108010801080108010801080108
010901090109010901090109010901090109010901090109010901090109010901090109010901090109000100010001000100010001000100010001000100010001000109010901090109010901010901090001000100010001000100010001000100010001000100010001000100010001000109010109010900010001000100010001000100010001000100010001000100010001000100010001090101090109000100010001000100010001000100010001000100010001000100010001000100010901010901090001000100010001000100010001000100010001000100010001000100010001000109010109010900010001000100010001000100010001000100010001000100010001000100010001000100090601030100010001000100010001000100010001000100010001000100010001000100010001000901090001000100010001000100010001000100010001000100010001000100010001000100010109010900010001000100010001000100010001000100010001000100010001000100010001000101090109000100010001000100010001000100010001000100010001000100010001000100010001010901090001000100010001000100010001000100010001000100010001000100010001000100010109010900010001000100010001000100010001000100010001000100010001000100010001000101090109000100010001000100010001000100010001040100010001000100010001000100010001010901090109010901090109010901090109010901090701010901090109010901090109010901090109
0108010801080108010801080108010801080700010801080108010801080108010801080108010801080000000000000000000000000000000000000000000000000000000000000000000000000108010800000000000000000000000000000000000000000000000000000000000000000000000001080108000000000800000000000000000000000000000000000000000000000800000000000000010801080000000000000000000000000000000004000000000000000000000000000000000000000108010800000000000000000000000000000400000004000000000000000000000000000000000001080108090000000000000000000000000000000000000000000000000000000000000000000000010801080900000000000000000000000000000000000000000000000000000000000000000000000600010809000000000000000000000000000000000000000000000002000400000000000000000001080108090000000000000000000000000000000000000000000000030000000000000000000000010801080000000000000000020000000000000000000000000000000000000000000000000000000108010800000000000002000000000000000000000000000000000000000000030000000000000001080108000000000000000000000000000000000000000000000000000000000000000000000000010801080000000000000000000000000000000000000000000000000A0000000A00000000000000010801080108010801080108010801080108010805000108010801080108010801080108010801080108
010A010A010A010A010A010A010A010A010A010A010A010A010A010A010A010A010A010A010A010A010A000200020002000200020002000200020002000200020002000200020002000200020002010A010A00020002000200020002010A000200020002000200020002000200020002000200020002010A010A00020002000200020002010A000200020002000200020002090200020002000200020002010A010A000200020002010A010A0002000200020002000200020002090200020002000200020002010A010A000200020002000200020002000200020002000200020002090200020002000200020002010A010A000200020002000200020002000200020002000200020002010A010A010A010A00020002010A0002000200020002000200020002000200020002000200020002000200020002000200020002010A010A000200020002000200020002000200020002000200020002000200020002090200020002010A010A000200020002000200020002000200020002000200020002000200020002000200020002010A010A00020002000200020002000200020002010A010A010A010A010A010A0002000200020902010A010A000200020002090200020002000200020002000200020002000200020002000200020002010A010A000200020002000200020002000200020002000200020002000200020002000200020002010A010A000200020002000200020002000200020002000200020002000200020002000200020002010A010A010A010A010A010A010A010A0002000200020002010A010A010A010A010A010A010A010A010A







010800080008000800080008000800080108010800000108010801080008000800080008010801080108010800080008000800080008000801080108000001080108010800080008010801080108010800000108010801080008000800080008010801080000010801080108010801080108010800000000000001080108010801080108000800080108010800000108010801080108010800000000000000000000000000000108010801080108010801080108000001080108000000000000000000000000000000000000000000000108010801080108010800000000010801080000000000000000000000000000000000000000000000000000000000000000000000000108010800000000000001080108000000000000000001080000000000000000000000000000000000000000000000000000010801080000000000000000000000000000000000000000000000000000010801080000000000000000000000000000000000000000000000000108010801080108000000000108010801080000000000000000000000000000010801080108010801080108010801080000000001080108010801080108000000000000000001080108010801080108010800080108010800000108010801080008010801080108010801080000010801080108000800080008000801080108000001080108010800080008000800080108010801080108010801080008000800080008010801080000010801080108000800080008000800080008010801080108010800080008000800080108010800000108010801080008000800080008000800080008