010801080108010801080108010801080108010801080108010801080108010801080108010801080108010801080108010801080108010801080108010801080108010801080108010801080108010801080108010809000108010801080108010801080108010801080108000000000108010800000000010801080000000000000000000000000108010801080108010800000000000000000000000000000108000000000000000000000000000000000108010801080000000000000000000000000000000001080000000000000000000000000000000000000000000000000000000000000000000000000000010800000000000000000000000000000000000000000000000000000000000000000000000000000108000000000000000000000000000009000108010800000000000000000000000000000000000001080000000000000000000000000000010801080108000000000000000000000000000000000000010800000000000000000000000000000108010800000000000000000000000000000000000000000108010800000000000000000000000000000000000000000000090000000000000000000000000001080108010800000000000000000000000000000108010801080108010809000000000000000000010801080108010801080000000001080108010801080108010801080108010801080000000000000108010801080108010801080108010801080108010801080108010801080108010801080108010801080108010801080108010801080108010801080108010801080108010801080108010801080108
0108010801080108010801080108010801080108010801080108010801080108010801080108010801080108010801080108010801080108010801080108010801080108010801080108010801080108000000000000000000000000000001080108010801080108010801080108010801080108010801080000000000000000000000000000000000000000010801080108010801080108010801080108010800000000000000000000000001080108010800000000000001080108010801080108010801080108000000000000000000000108010801080108010801080000000001080108010801080108010801080000000000000000010801080000000000000B0001080108000000000000000001080108010801080000000000000000010801080000000000000000000001080108000000000000000001080108010800000000000000000000000000000000000000000000000001080108000000000000010801080108000000000000000000000000000000000000000000000108010801080108000000000108010801080000000000000000000000000000000000000000000000000108010801080000000000000108010800000000000000000000000000000000000000000000000000000000000000000000000001080108000000000000010801080108010801080108010801080000000000000000000000000000010801080108010801080108010801080108010801080108010801080000000000000000000000000108010801080108010801080108010801080108010801080108010800000000000000000000000001080108








010F010F010F010F010F010F010F010F010F010F010F010F010F010F010F010F010F010F010F010F010F010F010F010F010F010F010F010F010F010F010F010F010F010F010F010F010F010F010F010F010F010F010F010F010F010F010F0007000700070007010F0007010F010F010F010F010F010F010F010F010F010F0007010F010F010F0007000700070007010F000700070007000700070007010F010F010F010F00070007000700070007000700070007000700070007000700070007000700070007010F010F000700070F07000700070007000700070A07000700070007000700070007090700070007010F010F00070007000700070007000700070007000700070007010B010B010B0007000700070007010F010F010F0007000700070007000700070007000700070007010B010B010B010B000700070007010F010F000700070007000700070007000700070007000700070007010B010B0007000700070007010F010F000700070907000700070007000700070007000709070007000700070007000700070007010F010F010F00070007000700070007000700070007000700070007000700070007000700070007010F010F010F00070007000700070007000700070007000700070007000700070007000700070007010F010F000700070007000700070007000700070007000700070007000700070007090700070007010F010F000700070007000700070007000700070007000700070007000700070007000700070007010F010F000700070007000700070007000700070007000700070007000700070007000700070007010F
010801080108010801080108010801080108010801080108000000000000000000000000010801080108010801080108010801080108010801080108010801080000000000000000000000000108010801080108010801080108010801080108010801080000000000000000000000000000000001080108010801080108010800000000000000000000000000000007000000000000000000000000010801080108010801080000000009000000000000000000000000000000000000000000000000000108010801080108000000000000000000000000000000070000000000000000000000000000000001080108010801080000000000070000000000000007000F0007000000000000000F0000000000000108010801080108000000000007000000000007000F0A0F000F000700000000000000000000000001080108010801080000000000000000000000000007000F00070000000000000900000700000000010801080108010800000000000000000000000000000007000000000000000700070007000000000108010801080108000009000000000000070000000000000000090F0000000000000000000009000108010801080108010800000000000000070000000000000000000000000000000F00000000010801080108010801080108010800000000000000000900090000000000000000000000000000000108010801080108010801080108010801080108010801080108010801080108010801080108010801080108010801080108010801080108010801080108010801080108010801080108010801080108010801080108








010F000700070007000700070007000700070007000700070007000700070007000700070007010F010F000700070007000700070007000700070007000700070007000700070007000700070007010F010F00070007000700070007000700070007000700070007000700070007000700070007010F010F010F00070007000700070007000700070007000700070007000700070007000700070907010F010F010F00070007000700070007000700070007000700070007000700070007000700070007010F010F010F010F00070007090700070007000700070007000700070007000700070007000700070007010F010F010F00070007000700070007000700070007000700070007000700070D070007000700070007010F010F000700070007000700070007000700070007000700070007000700070007000700070007010F010F010F00070007000700070007000700070007000700070007000700070007000700070007010F010F010F010F000700070D070007000700070007000700070007000700070007000700070007010F010F010F010F0007000700070007000700070007000700070007000700070007000700070007010F010F000700070007000700070007000700070007000700070007000700070007000700070007010F010F000709070007000700070007000700070007000700070007000700070007000700070007010F0007000700070007000700070007000700070007000700070007000700070007000700070007010F0007000700070007000700070007000700070007000700070007000700070007000700070007
010F010F010F010F010F010F010F010F010F010F010F010F010F010F010F010F010B010B010F010F010F0C0F010F010F010F010F0007000700070007000700070007000700070007010B010B00070007010F010F010F0007000700070007000700070007000700070907000700070007010B010B00070007010F010F00070007000700070007000700070007000700070007000700070007010B010B00070007010F010F00070007000700070907000700070007000700070007000700070007010B010B00070007010F000700070007000700070007000700070007000700070007000700070007010B000700070007000700070007000700070007000700070007000700070007000700070007020705070007000700070007000700070007000700070007000700070007000700070007000700070007010B0007000700070007000700070007000700070007000700070007000700070007000700070007010B010B000700070007000700070007000700070007000700070007000700070007000700070007010B010B000700070007000700070007000700070007000700070007000700070007000700070007010B010B0007000700070007000700070D0700070007000700070007000700070007000700070007010B010B0007000700070007000700070007000700070007000700070907000700070007000700070007010B010B010B000700070007000700070007000700070007000700070007000700070007000700070007010B010B000700070007000700070007000700070007000700070007000700070007000700070007010B010B
010F010F010F010F010F010F010F010F010F010F010F010F010F010F010F010F010F010F010F010F00070007000700070007000700070007010F00070007010F010F000F010F010F010F0007010F010F00070007000700070007000700070007010F00070007000700070007010F0007000700070007010F0007000700070007000700070007020705070007000700070007000707070007000700070007010F00070007000700070007000700070007010F00070007000700070007010F0007000700070007010F00070007000700070007000700070007010F00070007000700070007010F010F000700070007010F00070007000700070007000700070007010F010F000700070007010F010F010F000700070007010F00070007000700070007000700070007010F010F05070607010F010F010F010F000700070007010F00070007000700070007000700070007010F0007000700070007010F010F010F000700070007010F00070007000700070007000700070007010F00070007000700070007010F010F000700070007010F00070007000700070007000700070007010F00070007000700070007010F0007000700070007010F0007000700070007000700070007030706070007000700070007000707070007000700070007010F010F0007000700070007000700070007010F00070007000700070007010F0007000700070007010F010F010F000700070007000700070007010F0007010F010F00070007010F010F00070007010F010F010F010F010F010F010F010F010F010F010F010F010F010F010F010F010F010F010F010F010F010F