01080108010801080108010801080108010801080108010801080108010801080108010801080108010801080108010801080108010801080108010801080108010801080108010801080108010801080108010801080A00010801080108010801080108010801080108010800000000010801080000000001080108000000000000000000000000010801080108010801080000000000000000000000000000010800000000000000000000000000000000010801080108000000000000000000000000000000000108000000000000000000000000000000000000000000000000000000000000000000000000000001080000000000000000000000000000000000000000000000000000000000000000000000000000010800000000000000000000000000000A0001080108000000000000000000000000000000000000010800000000000000000000000000000108010801080000000000000000000000000000000000000108000000000000000000000000000001080108000000000000000000000000000000000000000001080108000000000000000000000000000000000000000000000A000000000000000000000000000108010801080000000000000000000000000000010801080108010801080A000000000000000000010801080108010801080000000001080108010801080108010801080108010801080000000000000108010801080108010801080108010801080108010801080108010801080108010801080108010801080108010801080108010801080108010801080108010801080108010801080108010801080108
0108010801080108010801080108010801080108010801080108010801080108010801080108010801080108010801080108010801080108010801080108010801080108010801080108010801080108000000000000000000000000000001080108010801080108010801080108010801080108010801080000000000000000000000000000000000000000010801080108010801080108010801080108010800000000000000000000000001080108010800000000000001080108010801080108010801080108000000000000000000000108010801080108010801080000000001080108010801080108010801080000000000000000010801080000000000000C0001080108000000000000000001080108010801080000000000000000010801080000000000000000000001080108000000000000000001080108010800000000000000000000000000000000000000000000000001080108000000000000010801080108000000000000000000000000000000000000000000000108010801080108000000000108010801080000000000000000000000000000000000000000000000000108010801080000000000000108010800000000000000000000000000000000000000000000000000000000000000000000000001080108000000000000010801080108010801080108010801080000000000000000000000000000010801080108010801080108010801080108010801080108010801080000000000000000000000000108010801080108010801080108010801080108010801080108010800000000000000000000000001080108
010B010B010B010B010B010B010B010B010B010B010B010B010B010B010B010B010B010B010B010B010B010B010B010B010B0D0B010B010B010900010001000101090109000100010001000101090109010B0D0B010901090109010B01090109000100010001000100010001000100010001000100010001010B010B01090001000100010001000100010A010001000100010001000100010001000100010001010B010900010001000100010001000100010001000100010A010001000100010001000100010001010B0109000100010001000100010001000100010001000100010001000100010001000100010001010B0001000100010001000100010001000100010001000100010001000100010001000100010001010B000100010B010001000100010001000100010001000100010001000100010E01000100010001010B0001000100010001000100010001000100010001000100010109000100010001000100010001010B0109000100010001000100010001000100010001000100010001000100010001000100010001010B010900010001000100010001000100010A010001000100010001000100010001000100010001010B010B000100010001000100010001000100010001000100010001000100010001000100010001010B010B000100010001000100010001000100010001000100010001000100010001000100010001010B0109000100010001000100010001000100010001000100010001000100010001000100010001010B0109000100010001000100010001000100010001000100010001000100010001000100010001







010F010F010F010F010F010F010F010F010F010F010F010F010F010F010F010F010F010F010F010F010F010F010F010F010F010F010F010F010F010F010F010F010F010F010F010F010F010F010F010F010F010F010F010F010F010F010F0007000700070007010F0007010F010F010F010F010F010F010F010F010F010F0007010F010F010F0007000700070007010F000700070007000700070007010F010F010F010F00070007000700070007000700070007000700070007000700070007000700070007010F010F000700071007000700070007000700070B070007000700070007000700070A0700070007010F010F00070007000700070007000700070007000700070007010B010B010B0007000700070007010F010F010F0007000700070007000700070007000700070007010B010B010B010B000700070007010F010F000700070007000700070007000700070007000700070007010B010B0007000700070007010F010F000700070A0700070007000700070007000700070A070007000700070007000700070007010F010F010F00070007000700070007000700070007000700070007000700070007000700070007010F010F010F00070007000700070007000700070007000700070007000700070007000700070007010F010F0007000700070007000700070007000700070007000700070007000700070A0700070007010F010F000700070007000700070007000700070007000700070007000700070007000700070007010F010F000700070007000700070007000700070007000700070007000700070007000700070007010F
01080108010801080108010801080108010801080108010800000000000000000000000001080108010801080108010801080108010801080108010801080108000000000000000000000000010801080108010801080108010801080108010801080108000000000000000000000000000000000108010801080108010801080000000000000000000000000000000700000000000000000000000001080108010801080108000000000A000000000000000000000000000000000000000000000000000108010801080108000000000000000000000000000000070000000000000000000000000000000001080108010801080000000000070000000000000007000F0007000000000000000F0000000000000108010801080108000000000007000000000007000F0B0F000F000700000000000000000000000001080108010801080000000000000000000000000007000F00070000000000000A0000070000000001080108010801080000000000000000000000000000000700000000000000070007000700000000010801080108010800000A0000000000000700000000000000000A0F000000000000000000000A000108010801080108010800000000000000070000000000000000000000000000000F00000000010801080108010801080108010800000000000000000A000A0000000000000000000000000000000108010801080108010801080108010801080108010801080108010801080108010801080108010801080108010801080108010801080108010801080108010801080108010801080108010801080108010801080108








010F000700070007000700070007000700070007000700070007000700070007000700070007010F010F000700070007000700070007000700070007000700070007000700070007000700070007010F010F00070007000700070007000700070007000700070007000700070007000700070007010F010F010F00070007000700070007000700070007000700070007000700070007000700070A07010F010F010F00070007000700070007000700070007000700070007000700070007000700070007010F010F010F010F000700070A0700070007000700070007000700070007000700070007000700070007010F010F010F00070007000700070007000700070007000700070007000700070E070007000700070007010F010F000700070007000700070007000700070007000700070007000700070007000700070007010F010F010F00070007000700070007000700070007000700070007000700070007000700070007010F010F010F010F000700070E070007000700070007000700070007000700070007000700070007010F010F010F010F0007000700070007000700070007000700070007000700070007000700070007010F010F000700070007000700070007000700070007000700070007000700070007000700070007010F010F00070A070007000700070007000700070007000700070007000700070007000700070007010F0007000700070007000700070007000700070007000700070007000700070007000700070007010F0007000700070007000700070007000700070007000700070007000700070007000700070007
010F010F010F010F010F010F010F010F010F010F010F010F010F010F010F010F010B010B010F010F010F0D0F010F010F010F010F0007000700070007000700070007000700070007010B010B00070007010F010F010F0007000700070007000700070007000700070A07000700070007010B010B00070007010F010F00070007000700070007000700070007000700070007000700070007010B010B00070007010F010F00070007000700070A07000700070007000700070007000700070007010B010B00070007010F000700070007000700070007000700070007000700070007000700070007010B000700070007000700070007000700070007000700070007000700070007000700070007020705070007000700070007000700070007000700070007000700070007000700070007000700070007010B0007000700070007000700070007000700070007000700070007000700070007000700070007010B010B000700070007000700070007000700070007000700070007000700070007000700070007010B010B000700070007000700070007000700070007000700070007000700070007000700070007010B010B0007000700070007000700070E0700070007000700070007000700070007000700070007010B010B0007000700070007000700070007000700070007000700070A07000700070007000700070007010B010B010B000700070007000700070007000700070007000700070007000700070007000700070007010B010B000700070007000700070007000700070007000700070007000700070007000700070007010B010B
010F010F010F010F010F010F010F010F010F010F010F010F010F010F010F010F010F010F010F010F00070007000700070007000700070007010F00070007010F010F010F010F010F010F0007010F010F00070007000700070007000700070007010F00070007000700070007010F0007000700070007010F0007000700070007000700070007020705070007000700070007000708070007000700070007010F00070007000700070007000700070007010F00070007000700070007010F0007000700070007010F00070007000700070007000700070007010F00070007000700070007010F010F000700070007010F00070007000700070007000700070007010F010F000700070007010F010F010F000700070007010F00070007000700070007000700070007010F010F05070607010F010F010F010F00070B070007010F00070007000700070007000700070007010F0007000700070007010F010F010F000700070007010F00070007000700070007000700070007010F00070007000700070007010F010F000700070007010F00070007000700070007000700070007010F00070007000700070007010F0007000700070007010F0007000700070007000700070007030706070007000700070007000708070007000700070007010F010F0007000700070007000700070007010F00070007000700070007010F0007000700070007010F010F010F000700070007000700070007010F0007010F010F00070007010F010F00070007010F010F010F010F010F010F010F010F010F010F010F010F010F010F010F010F010F010F010F010F010F010F







010F0007000700070007000700070007000700070007000700070007000700070007000700070007010F0007000700070007000700070007000700070007000700070007000700070007000700070007010F0007000700070007000700070007000700070007000700070007000700070007000700070007010F00070007000700070E0700070007000700070007000700070007000700070007000700070007010F000700070007000700070007000700070007000700070007000700070E070007000700070007010F000700070007000700070007010F010F010F0007000700070007000700070007000700070007010F00070007000700070007010F010F010F010F010F000700070007000700070007000700070007010F00070007000700070007010F010F010F0D0F010F010F00070007000700070007000700070007010F000700070007000700070007010F010F010F010F010F010F0007000700070007000700070007010F010F000700070007000700070007010F010F010F010F00070007000700070007000700070007010F010F000700070007000700070007000700070007000700070007000700070007000700070007010F010F0007000700070007000700070E0700070007000700070007000700070007000700070007010F0007000700070007000700070007000700070007000700070007000700070007000700070007010F0007000700070007000700070007000700070007000700070007000700070007000700070007010F0007000700070007000700070007000700070007000700070007000700070007000700070007
000700070007000700070007000700070007000700070007000700070007000700070007010B010B000700070007000700070007000700070007000700070007000700070007000700070007010B010B00070007000700070007000700070007000700070007000700070007000700070007010F010B010B0007000700070007000700070007000700070007000700070007000700070007010F010B010B010B0007000700070007000700070007000700070007000700070007000700070007010F010B010B010B0007000700070007000700070007000700070007000700070007000700070007010F010B0007000700070007000700070007000700070007000700070007000700070007000700070007010B000700070007000700070007000700070007000700070007000700070007000700070007000705070207000700070007000700070007000700070007000700070007000700070007000700070007010B000700070007000700070007000700070007000700070007000700070007000700070007010F010B000700070007000700070007000700070007000700070007000700070007010F010F010F0007010B010B010F0007000700070007000700070007000700070007000700070007010F090700070207010B010B010F0007000700070007000700070007000700070007000700070007010F000700070007010B010B010F000700070007000700070007000700070007000700070007010F010F010F010F010F010B010B010F000700070007000700070007010F010F010F010F010F010F010B010B010B010B010B010B010B010B