0108010801080108010801080108010801080108010801080108010801080108010801080108010801080A000A000A000A000A000000000000000000000000000000000000000000000000000B00010801080A0000000000000000000000000000000000000000000000000000000000000000000000010801080A0000000000000000000000000000000000000000000000000000000000000000000000010801080A0000000000000000000000000000000000000000000000000000000000000000000000010801080A00000000000000000000000000000000000000000000000000000000000000000000000108010800000000000000000000000000000000000000000000000000000000000000000000000001080108000000000000000000000000000000000000000000000000000000000000000000000200050001080000000000000000000000000000000000000000000000000000000000000000000000000108010800000000000000000000000000000000000000000000000000000000000000000000000001080108000000000000000000000000000000000000000000000000000000000000000000000000010801080000000000000000000000000000000000000000000000000000000000000000000000000108010800000000000000000000000000000000000000000000000000000000000000000000000001080108000000000000000000000000000000000300000000000000000000000000000000000000010801080108010801080108010801080108010806000108010801080108010801080108010801080108
01090109010901090109010901090109010901090109010901090109010901090109010901090109010900010001000100010001000100010001000100010001000100010A010A010A010A010A0101090109000100010001000100010001000100010001000100010001000100010001000100010A0101090109000100010001000100010001000100010001000100010001000100010001000100010A0101090109000100010001000100010001000100010001000100010001000100010001000100010A0101090109000100010001000100010001000100010001000100010001000100010001000100010A010109010900010001000100010001000100010001000100010001000100010001000100010001000100090601030100010001000100010001000100010001000100010001000100010001000100010001000901090001000100010001000100010001000100010001000100010001000100010001000100010109010900010001000100010001000100010001000100010001000100010001000100010001000101090109000100010001000100010001000100010001000100010001000100010001000100010001010901090001000100010001000100010001000100010001000100010001000100010001000100010109010900010001000100010001000100010001000100010001000100010001000100010001000101090109000100010001000100010001000100010001040100010001000100010001000100010001010901090109010901090109010901090109010901090701010901090109010901090109010901090109
01080108010801080108010801080108010807000108010801080108010801080108010801080108010800000000000000000000000000000000000000000000000000000000000000000000000001080108000000000000000000000000000000000000000000000000000000000000000000000000010801080000000008000000000000000000000000000000000000000000000008000000000000000108010800000000000000000000000000000000040000000000000000000000000000000000000001080108000000000000000000000000000004000000040000000000000000000000000000000000010801080A0000000000000000000000000000000000000000000000000000000000000000000000010801080A0000000000000000000000000000000000000000000000000000000000000000000000060001080A0000000000000000000000000000000000000000000000020004000000000000000000010801080A0000000000000000000000000000000000000000000000030000000000000000000000010801080000000000000000020000000000000000000000000000000000000000000000000000000108010800000000000002000000000000000000000000000000000000000000030000000000000001080108000000000000000000000000000000000000000000000000000000000000000000000000010801080000000000000000000000000000000000000000000000000B0000000B00000000000000010801080108010801080108010801080108010805000108010801080108010801080108010801080108
010A010A010A010A010A010A010A010A010A010A010A010A010A010A010A010A010A010A010A010A010A000200020002000200020002000200020002000200020002000200020002000200020002010A010A00020002000200020002010A000200020002000200020002000200020002000200020002010A010A00020002000200020002010A0002000200020002000200020A0200020002000200020002010A010A000200020002010A010A00020002000200020002000200020A0200020002000200020002010A010A0002000200020002000200020002000200020002000200020A0200020002000200020002010A010A000200020002000200020002000200020002000200020002010A010A010A010A00020002010A0002000200020002000200020002000200020002000200020002000200020002000200020002010A010A0002000200020002000200020002000200020002000200020002000200020A0200020002010A010A000200020002000200020002000200020002000200020002000200020002000200020002010A010A00020002000200020002000200020002010A010A010A010A010A010A0002000200020A02010A010A0002000200020A0200020002000200020002000200020002000200020002000200020002010A010A000200020002000200020002000200020002000200020002000200020002000200020002010A010A000200020002000200020002000200020002000200020002000200020002000200020002010A010A010A010A010A010A010A010A0002000200020002010A010A010A010A010A010A010A010A010A






010F010F010F010F010F010F00070007000700070007000700070007010F010F010F010F010F010F010F000700000000000000000000000000000000000000000000000000000000000000000000010F010F000200070007000000000000000000000000000000000000000000000000000000000000010F010F000200020D0200070000000000000000000000000000000000000E000000000000000000010F0007000200020002000200070000000000000000000000000000000000000000000000000000010F0007000200020002000200020007000000000000000000000000000000000000000000000000000700070002000200020002000200020007010901090109000000000000000000000000000000000007000700020002000200020002000200020109010901090000000000000000000000000000000000070007000200020002000200020002000201090109010900070000000000000000000000000000000700070002000200020002000200020002000200020002000200070000000000000000000000000007000700020002000200020002000200020002000200020002000200070000000000000000000000070007000200020002000200020002000200020002000200020002000200070007000000000000010F010F0002000200020002000200020002000200020C0200020002000200020002000700070000010F010F000200020002000200020002000200020002000200020002000200020002000200020007010F010F010F010F010F010F010F010F010F010F010F010F010F010F010F010F010F010F010F010F010F
010800080008000800080C080008000801080000010801080108010800080E08000800080108010801080108000800080008000800080008010800000108010801080108000800080108010801080108000001080108010800080008000800080108000001080108010801080108010801080108000000000000010801080108010801080008000801080000010801080108010801080108000000000000000000000000000001080108010801080108010800000108010801080000000000000000000000000000000000000000000001080108010801080108000000000108010800000000000000000000000000000000000000000000000000000000000000000C000E000108010800000000000001080108000000000000000001080000000000000000000000000000000000000000000000000000010801080000000000000000000000000000000000000000000000000000010801080000000000000000000000000000000000000000000000000108010801080108000000000108010801080000000000000000000000000000010801080108010801080108010801080000000001080108010801080108000000000000000001080108010801080108010800080108010800000108010801080008010801080108010801080000010801080108000800080008000801080108000001080108010800080008000800080108010801080108010801080008000800080008010801080000010801080108000800080008000800080008010801080108010800080E080F080008010801080000010801080108000800080E080008000800080008
010800080008000800080C080008000801080000010801080108010800080E08000800080108010801080108000800080008000800080008010800000108010801080108000800080108010801080108000001080108010800080008000800080108000001080108010801080108010801080108000000000000010801080108010801080008000801080000010801080108010801080108000000000000000000000000000001080108010801080108010800000108010801080000000000000000000000000000000000000000000001080108010801080108000000000108010800000000000000000000000000000000000000000000000000000000000000000C000E000108010800000000000001080108000000000000000001080000000000000000000000000000000000000000000000000000010801080000000000000000000000000000000000000000000000000000010801080000000000000000000000000000000000000000000000000108010801080108000000000108010801080000000000000000000000000000010801080108010801080108010801080000000001080108010801080108000000000000000001080108010801080108010800080108010800000108010801080008010801080108010801080000010801080108000800080008000801080108000001080108010800080008000800080108010801080108010801080008000800080008010801080000010801080108000800080008000800080008010801080108010800080E080F080008010801080000010801080108000800080E080008000800080008
01080108010801080108010801080108010801080108010801080108010801080108010801080108010800000000000000000000000000000000000000000000000000000000000000000000000001080108000000000000000000000000000000000000000000000000000000000000000000000000010801080000000000000E0000000000000000000E00000000000000000000000E000000000000000108010800000000000000000000000000000000000000000000000000000000000000000000000001080108000000000000000000000000000000000000000000000000000000000000000000000000010801080000000000000000000000000000000000000200000000000000000000000000000000000108010801080108010801080108010801080108050001080108010801080108010801080108010801080108000000000000000000000000000002000000000000000000000000000000000000000000010801080000000000000000000000000000000000000000000000000000000000000C0000000000010801080000000000000000000000000000000000000000000000000000000000000000000000000108010800000000000000000C000000000000000000000000000000000000000000000000000000010801080000000000000000000000000000000000000000000000000000000000000000000000000108010800000000000000000000000000000000000000000C000000000000000000000000000000010801080108010801080108010801080108010801080108010801080108010801080108010801080108