010801080108010801080108010801080108010801080108010801080108010801080108010801080108010801080108000000000000000000000000010801080108010801080108010801080108010801080108010800000000000000000000000000000000000000000000010801080108010801080108010801080108000000000000000000000000000000000000000000000000000001080108010801080108010800000000000000000000000000000000000000000000000000000000000001080108010801080108000000000000000000000000000000000000000000000000000000000000010801080108010801080108000000000000000000000000000000000000000000000000000000000000010801080108010801080000000000000000000000000000000000000000000000000000000000000108010801080108010800000000000000000000000000000000000000000000000000000000000000000108010801080108000000000000000000000000000000000000000000000000000000000000000000000108010801080000000000000000000000000000000000000000000000000000000000000000000001080108010800000000000000000000000000000000000000000000000000000000000000000000010801080108010800000000000000000000000000000000000000000000000000000000000000000108010801080108010801080000000000000000000000000000000000000000000000000000000001080108010801080108010801080000000000000000000000000000000000000000000000000000
0108010801080108010801080108010801080108010801080108010801080108010801080108010801080108010801080108010801080108010801080108010801080108010801080108010801080108010801080108010801080108010801080108010801080108010801080108010801080108010801080108010801080108010801080108010800000000000000000000010801080108010801080108010801080108010801080000000000000A00000000000C0000000A000000000000000108010801080108010801080108000000000C00000000000000000000000000000000000C0000000000010801080108010801080000000000000000000000000000000000000000000000000000000000000108010801080108000000000000000000000000000000000000000000000000000000000A00000000000108010801080000000000000000000000000000000000000000000000000000000000000000000001080108000000000000000000000000000000000000000000000000000000000000000000000000010801080000000000000000000000000000000000000000000000000000000000000000100000000108010800000000000000000000000000000000000000000000000000000000000000000000000001080108000000000000000000000000000000000000000000000000000000000000000000000000010801080000000000000000000000000000000000000000000000000000000000000000000000000108010800000000000000000000000000000000000000000000000000000000000000000000010801080108








01080108010801080108010801080000000000000000000000000000000000000000000000000000010801080108010801080000000000000000000000000000000000000000000000000000000000000108010801080108000000000000000000000000000000000000000000000000000000000000000001080108010800000000000000000000000000000000000000000000000000000000000000000000010801080108000000000000000000000000000000000000000000000000000000000000000000000108010800000000100000000000000000000000000000000000000000000000000000000000000001080108000000000000000000000000000000000000000000000000000000000000000000000000010801080108000000000000000000000000000000000000000000000000000000000000000000000108010801080108000000000000000000000000000000000000000000000000000000000000000001080108010801080108000000000000000000000000000000000000000000000000000000000000010801080D08010801080108010800000000000000000000000000000000000000000000000000000108010801080108010801080108010801080108010800000000000000000000000000000000000001080108010801080D080108010801080108010801080108010801080108000000000000000000000108010801080008010801080D08010801080108010801080108010801080108010801080108010801080108010801080108010801080108010801080108010801080108010801080108010801080108
0000000000000000000000000000000000000000000000000000000000000000000001080108010800000000000000000000000000000000000000000000000000000000000000000000010801080108000000000000000000000000000000000000000000000000000000000000000000000108010801080000000000000000000000000000000000000000000000000000000000000000000001080108010800000000000000000000000000000000000000000000000000000000000000000000010801080108000000000000000000000000000000000E000000000000000000000000000000000001080108010800000000000000000000000000000000000000000000000000000000000000000000010801080108000000000000000000000000000000000000000000000000000000000000000000000108010801080000000000000000000000000000000000000000000000000000000000000000000001080000010800000000000000000000000000000000000000000000000000001000000000000400060004000000000000000000000000000E000000000000000000000000000000000000000000030005000300000000000000000000000000000000000000000000000000000000000000000000000200070002000000000000000000000000000000000001080108010801080108010801080108010801080108000001080108010801080108010801080108010801080108010801080108010801080108010801080108010801080108010801080108010801080108010801080108010801080108010801080108010801080108
010801080108010801080108010801080108010801080108010801080108010801080108010801080108010801080108010801080108010801080108010801080108010801080108010801080108010801080108010801080108010801080108010801080108010801080108010801080108010801080108010801080108010801080108010801080108010801080108010801080108010801080108010801080108010801080108010801080108010801080008000000000000000000000000010801080108010801080108010801080108010800000000000000080000000010000000000000000000010801080108010801080108010801080000000010000000000800080000000000000000000000000000000000000108010801080000000000000000000000000000000800000000000000000000000000000000000001080000000000000000000000000000090000080008090000000000000000000000000000000000000000000000000000000000000000000000000800080000000000000000000000000000000000000000000000000000000000000000000000000008000800000000000000000000000000000000000000000000000000000000000000000000000000080000000000000000000000000000000000000000010801080108010801080108010801080108010801080108010801080108010800000000000000000108010801080108010801080108010801080108010801080108010801080108010801080108010801080108010801080108010801080108010801080108010801080108010801080108010801080108
0108010801080108010801080108010801080108010801080108010800080108000801080108010801080108010801080108010801080108010801080108010801080108010801080108010801080108010801080108010801080108010801080108010801080108010801080108010801080108010801080108010801080108010801080108010801080108010801080108010801080108010801080108010801080108010801080108010801080108010801080108010801080108010801080108010801080108010801080000000001080108010801080000000000000000000001080108010801080108010801080000000000000000000000000000000000000000000000000000000000000000000001080108010800000000000000000000000000000000000000000000100000000000000000000000010801080108000000000000000000000000000000000000000000000000000000000000000000000000010801080000000000000000000000000000000000000000000000000000000000000B0000000000010801080000000000000000000000000000000000000000000000000000000000000000000000000108010800000000000000000000000000000000000000000000000000000000000000000000010801080108000000000000000000000000000000000000010800000108010801080108010801080108010801080108010801080108010801080108010801080108010801080108010801080108010801080108010801080108010801080108010801080108010801080108010801080108010801080108010801080108
010B010B010B010B010B010B010B010B010B010B010B010B010B010B010B010B010B010B010B010B010B010B010B010B010B00030003000300030003010B00030003000300030003010B010B010B010B010B010B010B000300030003000300030003000300030003000300030003000300030003010B010B010B010B010B000300030003000300000000000000000000000000000003000300030003010B010B010B000300030003000300030000000000000000000000000108000000000003000300030003010B010B010B00030003000000000000010800000000000000000000000000000003000300030003010B010B00030003000300000000000000000000000000000000000000000000000300030003010B010B010B00030003000300000000000000000000000000000000000000000003000300030003010B010B010B00030003000300030000000000000000000000000000000000000003000000000003010B010B010B000300030003000300030000000000000000000000000000000000030108000300030003010B010B010B00030003000300030003000301080000000000000003000300030003000300030003010B010B010B000300030003000300030003000300030003000300030003000300030003010B010B010B010B010B010B0003000300030003000300030003000300030003010B010B010B010B010B010B010B010B010B010B0003000300030003010B000300030003010B010B010B010B010B010B010B010B010B010B010B010B010B010B010B010B010B010B010B010B010B010B010B010B010B010B010B010B010B